11111111111111111111111111111111
10100000000000000000100000000001
10100000000000000000100000111101
1010000000000000000C11C100100001
1000000000000000000000P100110001
11100000000000000000011110111101
1011110000000000000001000001E101
10000100000000000000000010010001
11111111111111111111111111111111