11111111111111111111111111111111
10100000000000000000000000000001
10100000000000000000000000000001
1010000000000000000C000000000001
1000000000000000000000P000000001
11100000000000000000000000000001
1E111100000000000000000000000001
10000100000000000000000000000001
11111111111111111111111111111111