11111111111111111111111111111111
10100000000000000000100000000001
10100000000000000000100000111101
10100000000000000000110100100001
10000000000000000000000100110001
11100000000000000000011110111101
1011110000000000000001000001C101
100001000000000000000000100P00E1
11111111111111111111111111111111