11111111111
10E000000x1
11111P00C01
11111111111