11111111111
10E00000001
11111P00C01
11111111111