11111111111111111111111111111111
10000000000000000000000000000001
10000000000000000001100000000001
1000000000000000001C011100000001
1000000C00000000000100P100000001
10000000000000000000011100000001
10000EC0000000000000000000000001
100000C0000000000000000000000001
11111111111111111111111111111111
