11111111111111111111111111111111
10000000000000000000000000000001
10000000000000000000000000000001
1000000000000000000C011100000001
1000000000000000000001P100000001
10000000000000000000011100000001
10000E00000000000000000000000001
10000000000000000000000000000001
11111111111111111111111111111111